737,737,737,737,737,737,737,737,737,737,737,737,737,737,737,737,737,737,737,737,737,737,737,737,737,737,737,737,737,737,737,737,737,737,737,737,737,737,737,737,737,737,737,737,737,737,737,737,737,737,737,737,737,737,737,737,737,737,737,737,737,737,737,737
737,737,737,737,737,737,737,737,737,737,737,737,737,737,737,737,737,737,737,737,737,737,737,737,737,737,737,737,737,737,737,737,737,737,737,737,737,737,737,737,737,737,737,737,737,737,737,737,737,737,737,737,737,737,737,737,737,737,737,737,737,737,737,737
737,737,737,737,737,737,737,737,737,737,737,737,737,737,737,737,737,737,737,737,737,737,737,737,737,737,737,737,737,737,737,737,737,737,737,737,737,737,737,737,737,737,737,737,737,737,737,737,737,737,737,737,737,737,737,737,737,737,737,737,737,737,737,737
737,737,737,737,737,737,737,737,737,737,737,737,737,737,737,737,737,737,737,737,737,737,737,737,737,737,737,737,737,737,737,737,737,737,737,737,737,737,737,737,737,737,737,737,737,737,737,737,737,737,737,737,737,737,737,737,737,737,737,737,737,737,737,737
737,737,737,737,737,737,737,737,737,737,737,737,737,737,737,737,737,737,737,737,737,737,737,737,737,737,737,737,737,737,737,737,737,737,737,737,737,737,737,737,737,737,737,737,737,737,737,737,737,737,737,737,737,737,737,737,737,737,737,737,737,737,737,737
737,737,737,737,737,737,737,737,737,737,737,737,737,737,737,737,737,737,737,737,737,737,737,737,737,737,737,737,737,737,737,737,737,737,737,737,737,737,737,737,737,737,737,737,737,737,737,737,737,737,737,737,737,737,737,737,737,737,737,737,737,737,737,737
737,737,737,737,737,737,737,737,737,737,737,737,737,737,737,737,737,737,737,737,737,737,737,737,737,737,737,737,737,737,737,737,737,737,737,737,737,737,737,737,737,737,737,737,737,737,737,737,737,737,737,737,737,737,737,737,737,737,737,737,737,737,737,737
737,737,737,737,737,737,737,737,737,737,737,737,737,737,737,737,737,737,737,737,737,737,737,737,737,737,737,737,737,737,737,737,737,737,737,737,737,737,737,737,737,737,737,737,737,737,737,737,737,737,737,737,737,737,737,737,737,737,737,737,737,737,737,737
737,737,737,737,737,737,737,737,737,737,737,737,737,737,737,737,737,737,737,737,737,737,737,737,737,737,737,737,737,737,737,737,737,737,737,737,737,737,737,737,737,737,737,737,737,737,737,737,737,737,737,737,737,737,737,737,737,737,737,737,737,737,737,737
737,737,737,737,737,737,737,737,737,737,737,737,737,737,737,737,737,737,737,737,737,737,737,737,737,737,737,737,737,737,737,737,737,737,737,737,737,737,737,737,737,737,737,737,737,737,737,737,737,737,737,737,737,737,737,737,737,737,737,737,737,737,737,737
737,737,737,737,737,737,737,737,737,737,737,737,737,737,737,737,737,737,737,737,737,737,737,737,737,737,737,737,523,464,523,465,522,464,465,523,465,465,737,737,737,737,737,737,737,737,737,737,737,737,737,737,737,737,737,737,737,737,737,737,737,737,737,737
737,737,737,737,737,737,737,737,737,737,737,737,737,737,737,737,737,737,737,737,737,737,737,737,737,464,522,523,465,523,522,465,523,464,523,464,464,523,465,522,464,737,737,737,737,737,737,737,737,737,737,737,737,737,737,737,737,737,737,737,737,737,737,737
737,737,737,737,737,737,737,737,737,737,737,737,737,737,737,737,737,737,737,737,737,737,737,464,522,522,522,523,523,464,465,465,522,464,465,465,523,464,523,522,464,523,522,737,737,737,737,737,737,737,737,737,737,737,737,737,737,737,737,737,737,737,737,737
737,737,737,737,737,737,737,737,737,737,737,737,737,737,737,737,737,737,737,737,737,465,522,522,522,523,522,464,522,523,465,465,523,522,523,465,523,522,523,465,523,464,522,522,522,737,737,737,737,737,737,737,737,737,737,737,737,737,737,737,737,737,737,737
737,737,737,737,737,737,737,737,737,737,737,737,737,737,737,737,737,737,737,737,522,465,522,522,522,522,465,465,522,522,522,522,464,464,464,523,522,464,465,523,464,523,464,464,465,523,737,737,737,737,737,737,737,737,737,737,737,737,737,737,737,737,737,737
737,737,737,737,737,737,737,737,737,737,737,737,737,737,737,737,737,737,523,523,465,522,523,465,523,465,465,464,523,465,523,464,522,465,523,523,523,465,523,465,464,465,464,523,465,522,522,522,737,737,737,737,737,737,737,737,737,737,737,737,737,737,737,737
737,737,737,737,737,737,737,737,737,737,737,737,737,737,737,737,737,464,523,464,464,523,522,464,464,522,464,522,465,465,464,522,522,522,464,464,464,465,464,523,522,522,464,465,522,523,523,522,465,737,737,737,737,737,737,737,737,737,737,737,737,737,737,737
737,737,737,737,737,737,737,737,737,737,737,737,737,737,737,737,522,465,523,522,523,465,523,523,465,522,522,465,523,464,465,523,523,522,465,523,522,523,464,464,523,522,465,523,464,464,464,464,522,464,737,737,737,737,737,737,737,737,737,737,737,737,737,737
737,737,737,737,737,737,737,737,737,737,737,737,737,737,737,523,523,464,522,465,464,464,464,523,465,523,465,465,523,464,465,465,465,523,464,464,522,464,522,464,464,464,465,465,523,464,464,464,465,523,523,737,737,737,737,737,737,737,737,737,737,737,737,737
737,737,737,737,737,737,737,737,737,737,737,737,737,737,737,522,522,464,465,523,522,465,522,522,465,523,465,523,464,522,523,465,522,465,464,522,464,464,465,465,522,465,465,523,523,465,523,523,522,464,523,737,737,737,737,737,737,737,737,737,737,737,737,737
737,737,737,737,737,737,737,737,737,737,737,737,737,737,465,464,523,522,465,522,465,465,464,465,522,523,465,522,523,465,464,523,522,464,465,522,523,465,523,465,523,464,465,523,522,465,465,464,465,522,522,523,737,737,737,737,737,737,737,737,737,737,737,737
737,737,737,737,737,737,737,737,737,737,737,737,737,464,522,523,523,465,522,465,523,465,522,465,523,465,464,464,465,523,465,522,523,522,522,465,465,522,523,522,523,465,523,465,465,523,523,522,522,464,464,523,522,737,737,737,737,737,737,737,737,737,737,737
737,737,737,737,737,737,737,737,737,737,737,737,737,464,465,523,522,523,522,464,522,464,522,522,464,465,465,523,523,464,465,523,465,464,522,522,523,464,465,464,465,464,523,465,522,523,523,522,464,523,523,523,523,737,737,737,737,737,737,737,737,737,737,737
737,737,737,737,737,737,737,737,737,737,737,737,465,465,522,464,464,464,522,465,523,522,522,522,522,464,522,523,522,523,522,464,523,464,465,465,465,464,465,465,522,465,464,464,464,465,523,465,522,465,464,465,465,464,737,737,737,737,737,737,737,737,737,737
737,737,737,737,737,737,737,737,737,737,737,737,464,464,464,464,523,465,464,523,465,522,523,465,465,522,522,523,522,523,464,465,464,464,465,464,523,465,464,464,464,522,464,523,465,465,523,464,465,464,523,522,465,464,737,737,737,737,737,737,737,737,737,737
737,737,737,737,737,737,737,737,737,737,737,522,522,523,523,464,522,464,464,465,523,523,464,464,523,522,523,465,464,465,465,465,523,522,464,522,522,464,465,465,522,465,522,523,465,523,523,523,523,522,522,522,523,464,522,737,737,737,737,737,737,737,737,737
737,737,737,737,737,737,737,737,737,737,737,523,523,523,465,464,523,522,523,523,522,465,523,523,464,464,523,464,465,465,465,523,464,465,522,523,465,464,522,465,522,464,465,465,522,465,465,464,522,522,523,523,523,522,522,737,737,737,737,737,737,737,737,737
737,737,737,737,737,737,737,737,737,737,737,465,522,465,523,523,523,523,523,465,523,464,523,523,522,465,465,465,465,522,464,522,523,522,465,465,465,522,465,523,522,464,465,465,522,523,522,522,465,465,522,465,465,523,522,737,737,737,737,737,737,737,737,737
737,737,737,737,737,737,737,737,737,737,523,465,522,465,465,464,464,522,464,523,465,523,523,465,464,464,522,523,523,522,523,464,523,522,465,464,523,523,464,465,464,522,523,522,465,464,523,522,523,523,522,464,523,523,522,464,737,737,737,737,737,737,737,737
737,737,737,737,737,737,737,737,737,737,465,523,465,523,465,522,465,522,465,522,465,464,522,464,522,465,522,522,523,523,522,465,522,522,522,464,464,465,465,522,464,464,465,522,522,465,523,464,465,465,523,465,523,523,523,464,737,737,737,737,737,737,737,737
737,737,737,737,737,737,737,737,737,737,522,523,465,522,464,522,523,465,522,522,523,523,523,465,522,523,522,464,464,465,523,465,522,464,523,523,523,523,522,522,523,465,464,523,523,464,464,523,523,522,522,464,522,465,523,464,737,737,737,737,737,737,737,737
737,737,737,737,737,737,737,737,737,737,464,465,464,465,464,523,522,523,522,522,523,465,465,523,523,464,465,464,464,464,522,522,523,522,523,523,523,464,523,523,465,464,465,464,464,464,523,464,465,523,464,465,523,523,465,465,737,737,737,737,737,737,737,737
737,737,737,737,737,737,737,737,737,737,465,522,464,465,465,523,464,522,523,464,522,464,523,464,464,465,523,464,464,523,522,523,523,522,523,523,464,465,522,464,464,522,522,523,465,464,464,464,523,523,465,523,464,465,522,465,737,737,737,737,737,737,737,737
737,737,737,737,737,737,737,737,737,737,465,522,464,522,465,522,464,523,464,465,465,465,523,465,522,465,523,522,522,523,523,522,464,523,522,465,464,522,465,523,522,523,523,465,522,523,522,522,464,465,464,464,522,523,522,523,737,737,737,737,737,737,737,737
737,737,737,737,737,737,737,737,737,737,464,465,464,465,522,464,464,522,523,523,465,522,465,465,464,522,522,522,523,522,523,522,522,522,523,464,465,465,522,523,522,464,464,464,464,522,523,523,465,464,522,522,465,464,465,523,737,737,737,737,737,737,737,737
737,737,737,737,737,737,737,737,737,737,465,523,522,465,464,465,523,465,465,522,523,465,522,464,465,464,522,464,523,523,464,522,465,522,464,522,464,522,464,523,522,465,464,522,523,522,464,523,522,465,465,465,464,464,464,464,737,737,737,737,737,737,737,737
737,737,737,737,737,737,737,737,737,737,465,523,465,523,522,464,465,523,523,465,522,465,464,464,523,465,464,465,522,464,465,465,465,464,522,464,523,464,522,522,522,523,522,523,522,465,523,464,522,522,523,465,465,464,522,465,737,737,737,737,737,737,737,737
737,737,737,737,737,737,737,737,737,737,464,465,464,464,465,464,465,465,523,522,464,465,522,465,464,522,523,522,464,465,465,465,523,522,522,464,522,523,522,522,522,522,522,523,465,464,464,464,464,522,522,465,522,464,522,522,737,737,737,737,737,737,737,737
737,737,737,737,737,737,737,737,737,737,737,465,523,465,522,522,464,464,522,522,523,465,464,465,464,523,522,523,465,464,464,523,522,464,465,523,522,523,465,523,523,464,464,522,522,522,465,523,523,522,522,522,464,465,464,737,737,737,737,737,737,737,737,737
737,737,737,737,737,737,737,737,737,737,737,465,523,523,523,523,464,522,523,465,464,523,465,523,523,464,465,465,523,464,464,523,523,465,523,523,465,465,522,523,464,523,522,522,464,465,465,465,523,522,522,522,522,523,523,737,737,737,737,737,737,737,737,737
737,737,737,737,737,737,737,737,737,737,737,523,465,464,522,522,522,522,465,523,523,523,464,465,522,465,464,465,465,522,465,523,465,523,465,464,464,522,522,464,465,522,465,465,465,465,522,465,522,522,465,522,523,523,523,737,737,737,737,737,737,737,737,737
737,737,737,737,737,737,737,737,737,737,737,737,523,522,465,523,522,522,464,464,522,465,523,522,464,465,522,465,523,522,465,464,523,522,465,464,464,464,522,465,465,464,465,523,523,523,464,523,465,464,464,464,522,523,737,737,737,737,737,737,737,737,737,737
737,737,737,737,737,737,737,737,737,737,737,737,522,464,464,523,464,464,522,522,523,523,465,465,464,523,465,464,464,522,523,464,464,464,464,523,465,522,523,523,523,464,464,522,465,465,522,465,522,465,464,464,464,522,737,737,737,737,737,737,737,737,737,737
737,737,737,737,737,737,737,737,737,737,737,737,737,465,465,523,464,465,522,465,522,522,464,523,465,523,522,464,464,522,465,523,522,465,465,464,465,465,522,465,522,523,523,522,465,464,523,464,464,465,464,464,522,737,737,737,737,737,737,737,737,737,737,737
737,737,737,737,737,737,737,737,737,737,737,737,737,523,465,522,522,464,523,522,464,522,464,523,464,523,523,465,522,523,464,464,464,523,465,465,464,464,464,464,522,465,465,522,465,522,464,464,522,523,464,523,522,737,737,737,737,737,737,737,737,737,737,737
737,737,737,737,737,737,737,737,737,737,737,737,737,737,464,522,522,522,464,465,465,465,465,464,523,465,465,522,522,465,523,465,465,523,523,523,523,465,464,464,523,523,523,522,465,522,465,464,522,464,522,522,737,737,737,737,737,737,737,737,737,737,737,737
737,737,737,737,737,737,737,737,737,737,737,737,737,737,737,464,464,465,523,522,465,465,523,522,523,522,523,523,522,523,465,464,465,522,523,464,465,465,464,464,522,522,464,523,522,523,464,464,464,522,465,737,737,737,737,737,737,737,737,737,737,737,737,737
737,737,737,737,737,737,737,737,737,737,737,737,737,737,737,465,464,464,464,465,523,523,465,523,465,522,465,465,522,465,523,522,523,465,523,523,464,464,465,465,465,464,464,523,465,464,522,522,465,464,465,737,737,737,737,737,737,737,737,737,737,737,737,737
737,737,737,737,737,737,737,737,737,737,737,737,737,737,737,737,464,523,523,522,465,523,522,464,465,465,522,464,522,464,465,465,464,523,464,522,464,465,523,523,464,464,465,523,465,465,523,464,465,464,737,737,737,737,737,737,737,737,737,737,737,737,737,737
737,737,737,737,737,737,737,737,737,737,737,737,737,737,737,737,737,464,523,465,464,523,523,522,522,522,465,523,522,464,522,465,523,523,465,522,522,523,523,523,523,464,465,464,464,522,522,522,464,737,737,737,737,737,737,737,737,737,737,737,737,737,737,737
737,737,737,737,737,737,737,737,737,737,737,737,737,737,737,737,737,737,523,464,465,464,523,464,522,464,465,465,465,464,523,465,523,522,465,523,522,523,465,465,522,464,464,465,464,523,522,464,737,737,737,737,737,737,737,737,737,737,737,737,737,737,737,737
737,737,737,737,737,737,737,737,737,737,737,737,737,737,737,737,737,737,737,737,465,465,523,464,523,465,464,465,465,464,464,522,465,464,523,522,465,464,464,464,465,522,465,523,523,522,737,737,737,737,737,737,737,737,737,737,737,737,737,737,737,737,737,737
737,737,737,737,737,737,737,737,737,737,737,737,737,737,737,737,737,737,737,737,737,523,464,523,523,523,464,464,464,464,465,522,522,522,464,522,464,464,465,465,465,464,465,523,464,737,737,737,737,737,737,737,737,737,737,737,737,737,737,737,737,737,737,737
737,737,737,737,737,737,737,737,737,737,737,737,737,737,737,737,737,737,737,737,737,737,737,523,464,522,465,523,465,523,465,465,465,522,523,464,523,522,464,464,523,522,522,737,737,737,737,737,737,737,737,737,737,737,737,737,737,737,737,737,737,737,737,737
737,737,737,737,737,737,737,737,737,737,737,737,737,737,737,737,737,737,737,737,737,737,737,737,737,522,522,464,523,522,522,522,465,522,465,523,464,522,465,465,464,737,737,737,737,737,737,737,737,737,737,737,737,737,737,737,737,737,737,737,737,737,737,737
737,737,737,737,737,737,737,737,737,737,737,737,737,737,737,737,737,737,737,737,737,737,737,737,737,737,737,737,465,522,465,522,522,464,522,522,465,522,737,737,737,737,737,737,737,737,737,737,737,737,737,737,737,737,737,737,737,737,737,737,737,737,737,737
737,737,737,737,737,737,737,737,737,737,737,737,737,737,737,737,737,737,737,737,737,737,737,737,737,737,737,737,737,737,737,737,737,737,737,737,737,737,737,737,737,737,737,737,737,737,737,737,737,737,737,737,737,737,737,737,737,737,737,737,737,737,737,737
737,737,737,737,737,737,737,737,737,737,737,737,737,737,737,737,737,737,737,737,737,737,737,737,737,737,737,737,737,737,737,737,737,737,737,737,737,737,737,737,737,737,737,737,737,737,737,737,737,737,737,737,737,737,737,737,737,737,737,737,737,737,737,737
737,737,737,737,737,737,737,737,737,737,737,737,737,737,737,737,737,737,737,737,737,737,737,737,737,737,737,737,737,737,737,737,737,737,737,737,737,737,737,737,737,737,737,737,737,737,737,737,737,737,737,737,737,737,737,737,737,737,737,737,737,737,737,737
737,737,737,737,737,737,737,737,737,737,737,737,737,737,737,737,737,737,737,737,737,737,737,737,737,737,737,737,737,737,737,737,737,737,737,737,737,737,737,737,737,737,737,737,737,737,737,737,737,737,737,737,737,737,737,737,737,737,737,737,737,737,737,737
737,737,737,737,737,737,737,737,737,737,737,737,737,737,737,737,737,737,737,737,737,737,737,737,737,737,737,737,737,737,737,737,737,737,737,737,737,737,737,737,737,737,737,737,737,737,737,737,737,737,737,737,737,737,737,737,737,737,737,737,737,737,737,737
737,737,737,737,737,737,737,737,737,737,737,737,737,737,737,737,737,737,737,737,737,737,737,737,737,737,737,737,737,737,737,737,737,737,737,737,737,737,737,737,737,737,737,737,737,737,737,737,737,737,737,737,737,737,737,737,737,737,737,737,737,737,737,737
737,737,737,737,737,737,737,737,737,737,737,737,737,737,737,737,737,737,737,737,737,737,737,737,737,737,737,737,737,737,737,737,737,737,737,737,737,737,737,737,737,737,737,737,737,737,737,737,737,737,737,737,737,737,737,737,737,737,737,737,737,737,737,737
737,737,737,737,737,737,737,737,737,737,737,737,737,737,737,737,737,737,737,737,737,737,737,737,737,737,737,737,737,737,737,737,737,737,737,737,737,737,737,737,737,737,737,737,737,737,737,737,737,737,737,737,737,737,737,737,737,737,737,737,737,737,737,737
